Level 2
10
10

SSSSSSSSSS
SMMMMRMMRS
SMMMRDMMMS
SMMMWWMMMS
SRMMWRMRMS
SRMMDMMMMS
SMMRMMRRDS
SMMMMDMMMS
SMMMMMMMMS
SSSSSSSSSS